"nulla"	"Document 3"
"placerat"	"Document 2"
"risus"	"Document 3"
"scelerisque"	"Document 3"
"elit"	"Document 1, Document 2, Document 3"
"condimentum"	"Document 2"
"consectetur"	"Document 1"
"dolor"	"Document 1"
"donec"	"Document 2"
"tortor"	"Document 2"
"varius"	"Document 2, Document 3"
"vel"	"Document 2"
"sit"	"Document 1, Document 3"
"lorem"	"Document 1"
"luctus"	"Document 3"
"amet"	"Document 1, Document 3"
"felis"	"Document 3"
"id"	"Document 2"
"ipsum"	"Document 1"
"laoreet"	"Document 2"
"ac"	"Document 3"
"adipiscing"	"Document 1"
"mattis"	"Document 3"
"mauris"	"Document 2"
